SO /Users/mteerlin/Documents/Project_Cub3d/Cub3d_gh/textures/Cracked_Deepslate_Bricks_(texture)_JE1.png
C 225,30,0
NO ./textures/Mossy_Stone_Bricks_(texture)_JE3_BE2.png
WE /Users/mteerlin/Documents/Project_Cub3d/Cub3d_gh/textures/Stone_Bricks_(texture)_JE3_BE2.png
EA ./textures/fakepng.png

F 220,100,0


11111
100N111111
1000000101
1000111111 
11111