NO ./textures/bricks.png
SO ./textures/cobblewall.png
WE ./textures/woodplanks_color.png
EA ./textures/woodplanks3.png

F 220,50,50
C 225,30,0

111111111111111111111111111111111111111111111111111111111111111111111111111111111111111111111111111111
1S0000000000000000000000000000000000000000000000000000000000000000000000000000000000000000000000000001
111111111111111111111111111111111111111111111111111111111111111111111111111111111111111111111111111111