NO ./textures/bricks.png
SO ./textures/cobblewall.png
WE ./textures/woodplanks_color.png
EA ./textures/woodplanks3.png

F 220,100,0
C 225,30,0

11111111111111111111111111111111111111111111111111111111111111111
1S000011101000000100010000011111111111111111111111111111111111111
10111010110010000101110010000000000000000000000000000000000000001
10101000100110000100010010011111111111111111111111111111111111111
10101011100011111111010010000000000000000000000000000000000000001
10101000101000100000010010011111111111111111111111111111111111111
10000000100100100011000010000000000000000000000000000000000000001
10001110111100010011000010011111111111111111111111111111111111111
11101100100000011000010010000000000000000000000000000000000000001
10001100000111001110011010011111111111111111111111111111111111111
10111111001101000000010010000000000000000000000000000000000000001
10100011001101111110010010011111111111111111111111111111111111111
10001001000000000000010000000000000000000000000000000000000000001
11111111111111111111111111111111111111111111111111111111111111111