NO ./textures/bricks.png
SO ./textures/cobblewall.png
WE ./textures/woodplanks_color.png
EA ./textures/woodplanks3.png

F 220,100,0
C 225,30,0

111111111111111111111111111111111111111111
1E0000000000001100000000011111111000000001
100000000000001100000000001111100000000001
111111111110001100000000000111000000000001
111111111100011100000111000010000111000001
111111110001111100000111100000001111000001
111111000011111100000111111111111111000001
111100001111111100000111111111111111000001
110000111111111100000111111111111111000001
100000000000000000000111111111111111000001
100000000000000000000111111111111111000001
111111111111111111111111111111111111111111