NO ./textures/bricks.png
SO ./textures/cobblewall.png
WE ./textures/woodplanks_color.png
EA ./textures/woodplanks3.png

F 220,100,0
C 225,30,0

11111            11111111111111111    11111
10001            11111111111111111    10001 
10001            11111111111111111    10001 
10001            11111111111111111    10001 
10001            11111111111111111    10001 
100011111111     11111111111111111    100011111111
10N0000   01     11111111111111111    10 000000001
100000000001     11111111111111111    100000000001
111111111111     11111111111111111    111111111111 